scheduleopsapi.batchdeletetasks 	 /cloudapi/TaskScheduler/v1/BatchDeleteTasksNew
scheduleopsapi.batchforcesuc 	 /api/taskScheduler/instance/batchForceSuc
scheduleopsapi.batchkill 	 /api/taskScheduler/instance/batchKill
scheduleopsapi.batchrerun 	 /api/taskScheduler/instance/batchRerun
scheduleopsapi.batchrun 	 /api/taskScheduler/task/batchRun
scheduleopsapi.batchstop 	 /cloudapi/TaskScheduler/v1/BatchStopWorkflows
scheduleopsapi.batchstoptasksnew 	 /cloudapi/TaskScheduler/v1/BatchStopTasksNew
scheduleopsapi.batchupdateowner 	 /cloudapi/TaskScheduler/v1/BatchModifyOwnersNew
scheduleopsapi.canvasinfo 	 /api/taskScheduler/workflow/canvasInfo
scheduleopsapi.countbycycleunitbyinstance 	 /api/taskScheduler/instance/countByCycleUnit
scheduleopsapi.countbycycleunitbytask 	 /api/taskScheduler/task/countByCycleUnit
scheduleopsapi.countbyresourcegroup 	 /api/taskScheduler/instance/countByExecutorGroupIds
scheduleopsapi.countbytasktypegroup 	 /api/taskScheduler/task/countByTaskTypeGroup
scheduleopsapi.countbytype 	 /api/taskScheduler/instanceStatusReport/instanceTrend
scheduleopsapi.countbytypebyinstancecycle 	 /api/taskScheduler/instanceCycleReport/countByType
scheduleopsapi.countbytypebytaskcycle 	 /api/taskScheduler/taskCycleReport/countByType
scheduleopsapi.countinstancestate 	 /cloudapi/TaskScheduler/v1/CountInstanceStateNew
scheduleopsapi.countworkflowtasks 	 /cloudapi/TaskScheduler/v1/CountTaskByWorkflow
scheduleopsapi.createmakeplan 	 /cloudapi/TaskScheduler/v1/CreateMakePlan
scheduleopsapi.createtasktags 	 /cloudapi/TaskScheduler/v1/CreateTaskTags
scheduleopsapi.daginstances 	 /api/taskScheduler/instance/dagInstances
scheduleopsapi.deleteparentinstances 	 /cloudapi/TaskScheduler/v1/DeleteParentInstances
scheduleopsapi.deleteworkflow 	 /cloudapi/TaskScheduler/v1/DeleteWorkflowNew
scheduleopsapi.describeinstanceloginfo 	 /cloudapi/TaskScheduler/v1/DescribeInstanceLogInfo
scheduleopsapi.describeinstancestatestatistic 	 /cloudapi/TaskScheduler/v1/DescribeInstanceStateStatistic
scheduleopsapi.describeoperatetaskdetail 	 /cloudapi/TaskScheduler/v1/DescribeOperateTaskDetail
scheduleopsapi.describeoperatetasksnew 	 /cloudapi/TaskScheduler/v1/DescribeOperateTasksNew
scheduleopsapi.describeoperatetasksnewforaiops 	 /cloudapi/TaskScheduler/v1/DescribeOperateTasksNewForAiops
scheduleopsapi.describeparentinstances 	 /cloudapi/TaskScheduler/v1/DescribeParentInstances
scheduleopsapi.describestatisticinstancestatus 	 /cloudapi/TaskScheduler/v1/DescribeStatisticInstanceStatus
scheduleopsapi.describetasktags 	 /cloudapi/TaskScheduler/v1/DescribeTaskTags
scheduleopsapi.diagnoseplus 	 /api/taskScheduler/instance/diagnosePlus
scheduleopsapi.diagnosepro 	 /api/taskScheduler/instance/diagnosePro
scheduleopsapi.downloadlog 	 /api/taskScheduler/instance/downloadLog
scheduleopsapi.downloadlogbycos 	 /api/taskScheduler/instance/downloadLogByCos
scheduleopsapi.eventcasesv2 	 /v1/events/cases/{projectId}/{category}/filterV2
scheduleopsapi.eventconsumelog 	 /v1/events/consume-task/{eventCaseId}
scheduleopsapi.findallbyfoldernew 	 /api/taskScheduler/folder/findAllByFolderNew
scheduleopsapi.findallusedversionson 	 /api/taskScheduler/task/findAllUsedVersionSon
scheduleopsapi.findbyworkflowid 	 /api/taskScheduler/workflow/schedule/info '前端调用'
scheduleopsapi.finddependtasklist 	 /api/taskScheduler/task/findDependTaskList
scheduleopsapi.finddependtasklists 	 /api/taskScheduler/task/findDependTaskLists
scheduleopsapi.finddependtasks 	 /cloudapi/TaskScheduler/v1/DescribeDependTasksNew
scheduleopsapi.findinstanceruntimelist 	 /api/taskScheduler/instance/findInstanceRunTimeList
scheduleopsapi.freezetasks 	 /cloudapi/TaskScheduler/v1/FreezeTasks
scheduleopsapi.freezetasksbymultiworkflow 	 /api/taskScheduler/workflow/freezeTasksByMultiWorkflow
scheduleopsapi.getalltasktype 	 /api/taskScheduler/taskType/getAllTaskType
scheduleopsapi.getfathers 	 /api/taskScheduler/instance/fathers
scheduleopsapi.getinstanceloglist 	 /api/taskScheduler/instance/logList
scheduleopsapi.getinstancesinfowithtaskinfo 	 /api/taskScheduler/instance/getInstancesInfoWithTaskInfo
scheduleopsapi.getlatestsystemmetric 	 /cloudapi/TaskScheduler/v1/BatchDescribeExecutorGroupLoaderSystemMetrics
scheduleopsapi.getsons 	 /api/taskScheduler/instance/sons
scheduleopsapi.getthirdtaskrunlog 	 /api/taskScheduler/instance/getThirdTaskRunLog
scheduleopsapi.getworkflows 	 /cloudapi/TaskScheduler/v1/DescribeOperateWorkflows
scheduleopsapi.list 	 /api/taskScheduler/instance/list
scheduleopsapi.listsuccessortaskinfos 	 /cloudapi/TaskScheduler/v1/DescribeSuccessorTaskInfosNew
scheduleopsapi.lookupevent 	 /v1/events/{projectId}/{name}/lookup
scheduleopsapi.makeup 	 /cloudapi/TaskScheduler/v1/MakeUpWorkflow
scheduleopsapi.makeuptasksnew 	 /cloudapi/TaskScheduler/v1/MakeUpTasksNew
scheduleopsapi.operatecanvasinfo 	 /api/taskScheduler/workflow/operateCanvasInfo
scheduleopsapi.runtasksbymultiworkflow 	 /api/taskScheduler/workflow/runTasksByMultiWorkflow
scheduleopsapi.runtimeinstancecnttop 	 /api/taskScheduler/instance/countRunTime
scheduleopsapi.taskcntbystatus 	 /api/taskScheduler/task/countByStatus
scheduleopsapi.taskstatustrend 	 /api/taskScheduler/taskStatusReport/taskStatusTrend
scheduleopsapi.updateowner 	 /api/taskScheduler/workflow/updateOwner
scheduleopsapi.workflowlist 	 /api/taskScheduler/workflow/list
dataintegrationservapi.batchforcesuc 	 /api/taskScheduler/instance/batchForceSuc
dataintegrationservapi.batchfreeze 	 /api/taskScheduler/task/batchFreeze
dataintegrationservapi.batchkill 	 /api/taskScheduler/instance/batchKill
dataintegrationservapi.checktasknameexist 	 /api/taskScheduler/task/checkTaskNameExist
dataintegrationservapi.deletetask 	 /api/taskScheduler/task/delete
dataintegrationservapi.getinstancelog 	 /api/taskScheduler/instance/getInstanceLog
dataintegrationservapi.getlastlog 	 /api/taskScheduler/instance/lastLog
dataintegrationservapi.getloglist 	 /api/taskScheduler/instance/logList
dataintegrationservapi.renametask 	 /api/taskScheduler/task/rename
instanceserviceapi.describesingledirectioninstancedag 	 cloudapi/TaskScheduler/v1/DescribeSingleDirectionInstanceDAG
makeplanoperateapi.killmakeplaninstance 	 /cloudapi/TaskScheduler/v1/KillMakePlanInstance
makeplanoperateapi.rerunmakeplaninstance 	 /cloudapi/TaskScheduler/v1/RerunMakePlanInstance
makeplanoperateapi.describemakeplan 	 /cloudapi/TaskScheduler/v1/DescribeMakePlan
makeplanoperateapi.describemakeplaninstance 	 /cloudapi/TaskScheduler/v1/DescribeMakePlanInstance
makeplanoperateapi.describemakeplantask 	 /cloudapi/TaskScheduler/v1/DescribeMakePlanTask
openplatformservapi.batchcreateaspects 	 /cloudapi/v1/TaskScheduler/TaskAspect/BatchCreateAspects
scheduleopsapi.batchrerun 	 /api/taskScheduler/instance/batchRerun
scheduleopsapi.batchupdateowner 	 /cloudapi/TaskScheduler/v1/BatchModifyOwnersNew
scheduleopsapi.diagnosepro 	 /api/taskScheduler/instance/diagnosePro
schedulerguldanapiv3.describequalityinstancelog 	 '存在多个同方法名，参数不一样'
taskexecutionservapi.downloadlogdata 	 /cloudapi/v1/TaskScheduler/Task/Instance/Instant/Log/Download
taskexecutionservapi.dryrun 	 /cloudapi/v1/TaskScheduler/Task/Instant/DryRun
taskexecutionservapi.dryrunv2 	 /cloudapi/v2/TaskScheduler/Task/Instant/DryRun
taskexecutionservapi.dryrunv3 	 /cloudapi/v3/TaskScheduler/Task/Instant/{TaskId}/DryRun
taskexecutionservapi.list 	 /cloudapi/v1/TaskScheduler/Task/Instance/Instant/{InstanceKey}/Lookup
taskexecutionservapi.log 	 /cloudapi/v1/TaskScheduler/Task/Instance/Instant/Log/{InstanceKey}
taskexecutionservapi.stop 	 /cloudapi/v1/TaskScheduler/Task/Instance/Instant/{InstanceKey}/Stop
taskexecutionservapi.stopv3 	 /cloudapi/v3/TaskScheduler/Task/Instance/Instant/{InstanceKey}/Stop
taskoperationservapi.batchdelete 	 /cloudapi/TaskScheduler/v1/BatchDeleteTasks
taskoperationservapi.batchstop 	 /cloudapi/TaskScheduler/v1/BatchStopTasks
taskoperationservapi.batchupdateowner 	 /cloudapi/TaskScheduler/v1/BatchModifyOwners
taskoperationservapi.gettasks 	 /cloudapi/TaskScheduler/v1/DescribeOperateTasks
taskoperationservapi.makeuptasks 	 /cloudapi/TaskScheduler/v1/MakeUpTasks
tbdsguldanapi.batchcreatetaskversion 	 '存在多个同方法名，参数不一样'
tbdsguldanapi.batchinfo 	 /tbds/inner/service/task/wedata/batchInfo
tbdsguldanapi.batchlast 	 /tbds/inner/service/instance/wedata/batchLast
tbdsguldanapi.batchrun 	 '存在多个同方法名，参数不一样'
tbdsguldanapi.batchtaskcommitandrun 	 /tbds/inner/service/task/wedata/batchTaskCommitAndRun
tbdsguldanapi.batchupdatetask 	 /tbds/inner/service/task/wedata/batchUpdate
tbdsguldanapi.businesscreatetask 	 /tbds/inner/service/task/wedata/create/business
tbdsguldanapi.checktaskdependence 	 /tbds/inner/service/task/wedata/checkDependence
tbdsguldanapi.checktasklink 	 /tbds/inner/service/task/wedata/checkLink
tbdsguldanapi.checkunifiedtaskdependency 	 /tbds/inner/service/task/wedata/unifiedTaskValidation
tbdsguldanapi.deletetask 	 '存在多个同方法名，参数不一样'
tbdsguldanapi.findbynameandproject 	 /tbds/inner/service/folder/wedata/findByNameAndProject
tbdsguldanapi.findbypage 	 /tbds/inner/service/task/wedata/findByPage
tbdsguldanapi.freezetask 	 /tbds/inner/service/task/wedata/freeze
tbdsguldanapi.getlastlog 	 '存在多个同方法名，参数不一样'
tbdsguldanapi.getrunlist 	 /tbds/inner/service/workflow/wedata/getRunList
tbdsguldanapi.info 	 '存在多个同方法名，参数不一样'
tbdsguldanapi.infotask 	 /tbds/inner/service/task/wedata/info
tbdsguldanapi.list 	 /tbds/inner/service/instance/wedata/list
tbdsguldanapi.rerunbatch 	 '存在多个同方法名，参数不一样'
tbdsguldanapi.runtask 	 /tbds/inner/service/task/wedata/run
tbdsguldanapi.selectprojectsqlparam 	 /tbds/inner/service/param/wedata/selectProjectSqlParam
tbdsguldanapi.stop 	 '存在多个同方法名，参数不一样'
tbdsguldanapi.stoptask 	 '存在多个同方法名，参数不一样'
tbdsguldanapi.updatetask 	 /tbds/inner/service/task/wedata/update
